{
  "rows": [
    "####################",
    "#..................#",
    "#.SSSSSSSS.SSSSSSS.#",
    "#..................#",
    "#.SSSSSSSS.SSSSSSS.#",
    "#..................#",
    "#..................#",
    "#..................#",
    "#..................#",
    "#..................#",
    "#..................#",
    "##########E#########"
  ]
}
